Setpoint_X,Setpoint_Y,INE,ISW,ISE,INW,ONE,ONW,OSE,OSW,CIR
1770,1770,7246,7326,7678,7714,743,723,707,718,0
1770,1770,7484,7314,7585,7643,743,723,707,718,0
1770,1770,7661,7262,7394,7820,742,723,707,718,0
1770,1770,7141,7226,7807,7647,742,723,707,718,0
1770,1770,7658,7224,7592,7685,742,723,707,718,0
1770,1770,7386,7230,7692,7685,742,723,707,718,0
1770,1770,7292,7337,7663,7654,742,723,707,718,0
1770,1770,7673,7212,7490,7772,742,723,707,718,0
1770,1770,7154,7255,7716,7684,742,723,707,718,0
1770,1770,7524,7267,7569,7707,742,723,707,718,0
1770,1770,7531,7230,7556,7743,742,723,707,718,0
1770,1770,7241,7304,7686,7677,743,723,708,718,0
1770,1770,7736,7242,7513,7723,742,723,707,718,0
1770,1770,7349,7326,7617,7697,742,723,706,717,0
1770,1770,7454,7304,7641,7598,742,723,707,718,0
1770,1770,7681,7209,7531,7706,742,723,707,718,0
1770,1770,7171,7236,7812,7635,742,723,707,718,0
1770,1770,7661,7240,7600,7672,743,724,707,718,0
1770,1770,7422,7248,7663,7668,742,723,707,718,0
1770,1770,7291,7242,7829,7584,743,724,708,719,0
1770,1770,7710,7187,7578,7720,742,723,707,718,0
1770,1770,7188,7221,7891,7549,743,723,707,718,0
1770,1770,7515,7196,7795,7573,743,723,707,718,0
1770,1770,7637,7143,7713,7647,742,724,708,718,0
1770,1770,7108,7184,8034,7526,742,723,708,718,0
1770,1770,7736,7157,7655,7665,743,723,707,718,0
1770,1770,7367,7309,7770,7674,742,723,708,718,0
1770,1770,7268,7262,7790,7566,742,723,707,718,0
1770,1770,7750,7142,7487,7735,742,723,707,718,0
1770,1770,7101,7147,7959,7602,742,723,707,718,0
1770,1770,7539,7199,7705,7640,742,723,707,718,0
1770,1770,7627,7176,7613,7724,742,723,707,718,0
1770,1770,7099,7181,7972,7537,742,723,707,718,0
1770,1770,7764,7185,7457,7718,742,723,707,718,0
1770,1770,7348,7392,7628,7639,743,722,707,718,0
1770,1770,7344,7363,7632,7589,742,724,707,718,0
1770,1770,7760,7200,7359,7813,742,723,707,718,0
1770,1770,7097,7231,7857,7640,742,723,707,718,0
1770,1770,7597,7288,7544,7667,743,723,707,718,0
1770,1770,7607,7198,7517,7716,743,723,707,718,0
1770,1770,7164,7205,7920,7575,743,723,707,718,0
1770,1770,7820,7179,7377,7764,743,723,707,718,0
1770,1770,7348,7347,7613,7700,742,722,707,718,0
1770,1770,7354,7328,7598,7610,741,723,707,718,0
1770,1770,7780,7209,7307,7854,742,723,707,718,0
1770,1770,7132,7251,7818,7661,742,723,707,718,0
1770,1770,7619,7253,7491,7748,742,723,707,718,0
1770,1770,7585,7238,7461,7807,742,723,707,718,0
1770,1770,7120,7193,7842,7620,742,723,707,718,0
1770,1770,7762,7189,7332,7852,742,723,707,718,0
1770,1770,7275,7312,7594,7705,742,723,708,718,0
1770,1770,7398,7339,7586,7663,742,723,707,718,0
1770,1770,7700,7202,7360,7840,743,723,707,718,0
1770,1770,7120,7250,7813,7658,742,723,707,718,0
1770,1770,7632,7250,7491,7731,743,724,708,719,0
1770,1770,7501,7214,7592,7749,742,724,707,718,0
1770,1770,7194,7272,7798,7629,743,723,708,719,0
1770,1770,7791,7235,7367,7870,742,723,707,718,0
1770,1770,7280,7370,7650,7773,742,723,707,718,0
1770,1770,7508,7335,7611,7694,743,723,708,718,0
1770,1770,7795,7266,7401,7860,743,724,708,719,0
1770,1770,7195,7254,7873,7657,742,723,707,718,0
1770,1770,7748,7268,7506,7766,742,724,707,718,0
1770,1770,7524,7304,7572,7766,742,723,707,718,0
1770,1770,7260,7295,7729,7609,742,723,707,718,0
1770,1770,7799,7204,7393,7786,742,723,707,717,0
1770,1770,7196,7282,7680,7682,742,723,707,718,0
1770,1770,7506,7326,7581,7716,742,723,707,718,0
1770,1770,7668,7242,7507,7819,742,723,707,718,0
1770,1770,7169,7254,7837,7665,742,722,707,718,0
1770,1770,7724,7275,7488,7795,742,723,707,718,0
1770,1770,7430,7363,7652,7761,743,723,706,718,0
1770,1770,7303,7367,7717,7626,742,723,707,718,0
1770,1770,7787,7228,7446,7795,742,723,707,718,0
1770,1770,7151,7185,7907,7604,742,723,707,718,0
1770,1770,7556,7201,7683,7644,742,723,707,718,0
1770,1770,7614,7228,7541,7731,742,723,707,718,0
1770,1770,7160,7249,7886,7594,742,723,707,718,0
1770,1770,7775,7186,7450,7730,743,723,707,718,0
1770,1770,7352,7356,7659,7689,742,723,707,718,0
1770,1770,7278,7351,7730,7590,742,723,707,718,0
1770,1770,7792,7203,7517,7764,742,723,707,718,0
1770,1770,7122,7241,7933,7623,742,723,707,718,0
1770,1770,7629,7210,7724,7634,743,723,707,718,0
1770,1770,7671,7177,7637,7738,742,724,708,718,0
1770,1770,7185,7192,8040,7524,742,723,707,718,0
1770,1770,7872,7206,7493,7781,742,723,707,718,0
1770,1770,7298,7308,7750,7684,742,723,707,718,0
1770,1770,7322,7320,7796,7574,742,723,707,718,0
1770,1770,7860,7179,7399,7870,743,723,707,718,0
1770,1770,7119,7135,8105,7501,742,723,707,718,0
1770,1770,7635,7207,7632,7666,742,723,707,718,0
1770,1770,7679,7236,7519,7737,742,723,707,718,0
1770,1770,7121,7206,7974,7458,742,722,707,718,0
1770,1770,7877,7219,7307,7803,742,723,707,718,0
1770,1770,7283,7342,7589,7687,742,723,707,718,0
1770,1770,7255,7298,7700,7560,742,723,707,718,0
1770,1770,7916,7193,7241,7826,743,723,707,717,0
1770,1770,7105,7169,7866,7545,742,723,707,718,0
1770,1770,7627,7224,7545,7657,742,723,707,718,0
1770,1770,7703,7211,7446,7778,742,723,707,718,0
1770,1770,7143,7228,7907,7473,742,723,707,718,0
1770,1770,7925,7192,7364,7767,742,723,707,718,0
1770,1770,7360,7319,7650,7645,743,723,707,718,0
1770,1770,7260,7238,7781,7525,742,723,707,718,0
1770,1770,7965,7177,7291,7840,742,723,707,718,0
1770,1770,7134,7183,7897,7545,742,723,707,717,0
1770,1770,7643,7236,7575,7639,743,723,708,718,0
1770,1770,7753,7262,7503,7753,742,723,707,718,0
1770,1770,7132,7231,7926,7506,742,723,708,718,0
1770,1770,7905,7140,7370,7751,742,723,707,718,0
1770,1770,7312,7268,7627,7680,742,723,707,718,0
1770,1770,7240,7218,7835,7516,742,723,707,718,0
1770,1770,7899,7190,7289,7875,742,723,707,718,0
1770,1770,7055,7115,8019,7551,743,722,707,718,0
1770,1770,7595,7200,7651,7619,742,723,707,718,0
1770,1770,7681,7191,7483,7765,742,723,707,718,0
1770,1770,7108,7174,8027,7502,742,723,708,718,0
1770,1770,7837,7143,7413,7733,742,723,707,718,0
1770,1770,7271,7254,7706,7614,743,723,707,718,0
1770,1770,7272,7257,7869,7477,742,723,707,718,0
1770,1770,7826,7153,7364,7806,743,723,708,718,0
1770,1770,7146,7191,8069,7503,742,723,706,718,0
1770,1770,7661,7223,7720,7584,743,723,708,718,0
1770,1770,7650,7200,7641,7669,742,723,707,718,0
1770,1770,7111,7184,7984,7500,742,723,707,718,0
1770,1770,7852,7135,7456,7740,742,723,707,718,0
1770,1770,7161,7184,7822,7646,742,723,707,718,0
1770,1770,7270,7223,7800,7570,742,723,708,718,0
1770,1770,7802,7161,7477,7820,743,723,707,718,0
1770,1770,7033,7214,7944,7566,742,723,707,718,0
1770,1770,7617,7240,7595,7692,742,723,708,718,0
1770,1770,7525,7205,7689,7634,742,723,707,718,0
1770,1770,7106,7251,7910,7536,742,723,707,718,0
1770,1770,7877,7109,7434,7775,742,723,707,718,0
1770,1770,7159,7179,7848,7621,742,723,707,718,0
1770,1770,7342,7236,7808,7529,742,723,707,718,0
1770,1770,7818,7142,7386,7770,742,723,707,718,0
1770,1770,7046,7208,7985,7466,742,722,707,717,0
1770,1770,7746,7184,7637,7616,742,723,707,718,0
1770,1770,7522,7207,7668,7692,742,723,708,718,0
1770,1770,7128,7318,7916,7516,742,723,707,718,0
1770,1770,7995,7206,7416,7784,743,723,707,718,0
1770,1770,7109,7199,7952,7577,742,723,707,718,0
1770,1770,7343,7372,7683,7583,742,723,707,718,0
1770,1770,7874,7136,7445,7815,743,723,707,718,0
1770,1770,6981,7201,8027,7488,742,723,707,718,0
1770,1770,7744,7190,7622,7684,742,723,707,718,0
1770,1770,7527,7188,7750,7651,742,723,707,718,0
1770,1770,7023,7219,7944,7459,742,723,707,718,0
1770,1770,7956,7159,7273,7828,742,722,707,718,0
1770,1770,7090,7212,7894,7563,742,724,707,718,0
1770,1770,7302,7278,7873,7510,742,723,707,718,0
1770,1770,7930,7160,7414,7783,742,723,707,718,0
1770,1770,6973,7205,8058,7463,742,723,707,718,0
1770,1770,7723,7169,7574,7647,743,723,707,718,0
1770,1770,7605,7173,7676,7636,742,723,707,718,0
1770,1770,7101,7239,8040,7454,743,723,707,718,0
1770,1770,8003,7158,7389,7818,742,723,707,718,0
1770,1770,7146,7210,7978,7524,742,723,707,719,0
1770,1770,7297,7323,7783,7498,743,723,707,718,0
1770,1770,7891,7117,7373,7852,742,723,707,718,0
1770,1770,7014,7207,8020,7499,742,723,707,718,0
1770,1770,7745,7190,7628,7633,743,724,707,718,0
1770,1770,7572,7212,7624,7700,743,723,708,718,0
1770,1770,7075,7174,8085,7469,743,724,708,719,0
1770,1770,7965,7174,7383,7802,742,723,707,718,0
1770,1770,7152,7172,7978,7582,743,723,708,718,0
1770,1770,7321,7272,7816,7495,742,723,707,718,0
1770,1770,7893,7221,7336,7827,743,723,708,719,0
1770,1770,7079,7207,7998,7548,742,723,707,718,0
1770,1770,7752,7237,7598,7626,743,724,707,718,0
1770,1770,7538,7207,7668,7666,742,723,707,718,0
1770,1770,7103,7185,8005,7525,743,723,708,718,0
1770,1770,7870,7217,7355,7806,743,723,707,718,0
1770,1770,7132,7209,7842,7651,742,723,707,718,0
1770,1770,7357,7303,7648,7544,742,723,707,718,0
1770,1770,7775,7217,7437,7730,743,724,708,718,0
1770,1770,7057,7268,7884,7540,742,723,707,718,0
1770,1770,7711,7221,7511,7676,742,723,708,718,0
1770,1770,7443,7256,7648,7679,742,723,707,718,0
1770,1770,7162,7212,7926,7522,742,723,707,718,0
1770,1770,7827,7207,7322,7829,742,722,707,718,0
1770,1770,7082,7210,7854,7635,742,723,707,718,0
1770,1770,7458,7251,7724,7654,742,723,707,718,0
1770,1770,7696,7271,7390,7839,742,723,707,718,0
1770,1770,7123,7249,7948,7545,742,723,707,718,0
1770,1770,7774,7252,7471,7801,742,723,707,718,0
1770,1770,7358,7334,7641,7750,742,723,707,718,0
1770,1770,7191,7259,7908,7609,742,723,707,718,0
1770,1770,7813,7222,7437,7807,742,723,707,718,0
1770,1770,7114,7218,8001,7575,742,723,707,718,0
1770,1770,7561,7265,7657,7673,743,723,708,718,0
1770,1770,7690,7232,7533,7777,742,723,707,718,0
1770,1770,7123,7250,7896,7567,742,723,707,718,0
1770,1770,7868,7213,7385,7782,742,723,707,718,0
1770,1770,7286,7294,7775,7660,742,723,707,718,0
1770,1770,7257,7340,7748,7640,742,723,707,718,0
1770,1770,7886,7267,7311,7870,742,723,707,718,0
1770,1770,7117,7270,7998,7500,743,723,707,718,0
1770,1770,7670,7318,7539,7604,742,724,707,718,0
1770,1770,7719,7365,7425,7714,742,723,707,718,0
1770,1770,7142,7340,7829,7508,741,723,707,718,0
1770,1770,7888,7229,7214,7799,742,723,707,718,0
1770,1770,7220,7315,7642,7630,742,723,707,718,0
1770,1770,7235,7319,7641,7556,742,723,707,718,0
1770,1770,7787,7181,7286,7798,742,723,707,718,0
1770,1770,7010,7197,7876,7531,742,723,707,718,0
1770,1770,7585,7241,7522,7663,743,723,708,718,0
1770,1770,7520,7220,7538,7723,743,723,707,718,0
1770,1770,7079,7221,7882,7504,742,723,707,718,0
1770,1770,7806,7148,7388,7728,742,723,706,718,0
1770,1770,7134,7211,7778,7647,742,723,706,718,0
1770,1770,7228,7245,7737,7611,742,723,707,718,0
1770,1770,7772,7181,7355,7787,742,723,707,718,0
1770,1770,7058,7262,7905,7530,742,724,707,718,0
1770,1770,7678,7256,7554,7624,742,723,707,718,0
1770,1770,7530,7219,7580,7676,743,723,708,718,0
1770,1770,7133,7255,7888,7493,742,723,707,718,0
1770,1770,7859,7220,7359,7778,743,723,707,718,0
1770,1770,7175,7262,7813,7630,742,724,708,718,0
1770,1770,7304,7320,7708,7612,742,723,707,718,0
